22 22
31 27 27 27 27 27 27 27 27 27 27 27 27 27 27 27 27 27 27 27 27 31
29 0 0 0 0 0 0 0 0 0 0 0 0 0 0 0 0 0 0 0 0 23
29 0 0 0 0 0 0 0 0 0 0 0 0 0 0 0 0 0 0 0 0 23
29 0 0 0 0 0 0 0 0 0 0 0 0 0 0 0 0 0 0 0 0 23
29 0 0 0 0 0 0 0 0 0 0 0 0 0 0 0 0 0 0 0 0 23
29 0 0 0 0 0 0 0 0 0 0 0 0 0 0 0 0 0 0 0 0 23
29 0 0 0 0 0 0 0 0 0 0 0 0 0 0 0 0 0 0 0 0 23
29 0 0 0 0 0 0 0 0 0 0 0 0 0 0 0 0 0 0 0 0 23
29 0 0 0 0 0 0 0 0 0 0 0 0 0 0 0 0 0 0 0 0 23
29 0 0 0 0 0 0 0 0 0 0 0 0 0 0 0 0 0 0 0 0 23
29 0 0 0 0 0 0 0 0 0 0 0 0 0 0 0 0 0 0 0 0 23
29 0 0 0 0 0 0 0 0 0 0 0 0 0 0 0 0 0 0 0 0 23
29 0 0 0 0 0 0 0 0 0 0 0 0 0 0 0 0 0 0 0 0 23
29 0 0 0 0 0 0 0 0 0 0 0 0 0 0 0 0 0 0 0 0 23
29 0 0 0 0 0 0 0 0 0 0 0 0 0 0 0 0 0 0 0 0 23
29 0 0 0 0 0 0 0 0 0 0 0 0 0 0 0 0 0 0 0 0 23
29 0 0 0 0 0 0 0 0 0 0 0 0 0 0 0 0 0 0 0 0 23
29 0 0 0 0 0 0 0 0 0 0 0 0 0 0 0 0 0 0 0 0 23
29 0 0 0 0 0 0 0 0 0 0 0 0 0 0 20 0 0 0 0 0 23
29 0 0 0 0 0 0 0 0 0 0 0 0 22 30 29 0 0 0 0 7 23
29 0 0 0 0 0 22 30 28 0 0 0 0 23 31 29 0 0 0 0 6 23
31 30 30 30 30 30 31 31 31 30 30 30 30 31 31 31 30 30 30 30 30 31
