22 22
31 27 27 27 27 27 27 27 27 27 27 27 27 27 27 27 27 27 27 27 27 31
29 0 0 0 0 0 0 0 0 0 0 0 0 0 0 0 0 0 0 0 0 23
29 0 0 0 0 0 0 0 0 0 0 0 0 0 0 0 0 0 0 0 0 23
29 0 0 0 0 0 0 0 0 0 0 0 0 0 0 0 0 0 0 0 0 23
29 0 0 0 0 0 0 0 0 0 0 0 0 0 0 0 0 0 0 0 0 23
29 0 0 0 0 0 0 0 0 0 0 0 0 0 0 0 0 0 0 0 0 23
29 0 0 0 0 0 0 0 0 0 0 0 0 0 0 0 0 0 0 0 0 23
29 0 0 0 0 0 0 0 12 13 14 0 0 0 22 30 24 0 0 0 18 31
29 0 0 0 0 0 0 0 0 0 0 0 0 0 23 29 0 12 13 14 0 23
29 0 0 12 13 14 0 0 0 0 0 0 0 0 23 29 0 0 0 0 0 23
29 0 0 0 0 0 0 0 0 0 0 0 0 0 23 31 24 0 0 0 18 31
29 0 0 0 0 0 0 0 0 0 0 0 0 0 23 29 0 12 13 14 0 23
29 0 0 0 0 0 0 12 13 14 0 0 0 0 23 29 0 0 0 0 0 23
29 0 0 0 0 0 0 0 0 0 0 0 0 0 23 31 24 0 0 0 18 31
29 0 0 0 0 0 0 0 0 0 0 0 0 0 23 29 0 12 13 14 0 23
29 0 0 0 0 0 0 0 0 0 0 0 22 30 31 29 0 0 0 0 0 23
29 0 0 0 0 0 0 0 12 13 14 0 23 31 31 31 24 0 0 0 18 31
29 0 0 0 0 0 0 0 0 0 0 0 23 31 31 29 0 12 13 14 0 23
29 0 0 0 0 0 0 0 0 0 0 0 23 31 31 29 0 0 0 0 0 23
29 0 0 0 0 12 13 14 0 0 0 0 23 31 31 29 0 0 7 0 0 23
29 0 0 0 0 0 0 0 0 0 0 0 23 31 31 29 0 0 6 0 0 23
31 30 30 30 30 30 30 30 30 30 30 30 31 31 31 31 30 30 30 30 30 31

