22 22
31 27 27 27 27 27 27 27 27 27 27 27 27 27 27 27 27 27 27 27 27 31
29 0 0 0 0 0 0 0 0 0 0 0 0 0 0 0 0 0 0 0 0 23
29 0 0 0 0 0 0 0 0 0 0 0 0 0 0 0 0 0 0 0 7 23
29 0 0 0 0 0 0 0 0 0 0 0 0 0 0 0 0 0 0 0 6 23
29 0 0 0 0 0 0 0 0 0 0 0 0 0 0 0 0 0 18 26 26 31
29 0 0 0 0 0 0 0 0 0 0 0 0 0 0 0 0 0 0 0 0 23
29 0 0 0 0 0 0 0 0 22 28 0 0 0 0 0 0 0 0 0 0 23
29 0 0 0 0 0 0 0 0 23 29 0 0 0 0 0 0 0 0 0 0 23
29 0 0 0 0 0 0 0 0 23 29 0 0 0 0 0 0 0 0 0 0 23
29 0 0 0 0 18 26 26 26 27 25 0 0 0 0 0 0 0 0 0 0 23
29 0 0 0 0 0 0 0 0 0 0 0 0 0 0 0 0 0 0 0 0 23
29 0 0 0 0 0 0 0 0 0 0 0 0 0 0 0 0 0 0 0 0 23
29 26 26 26 26 26 26 26 26 26 26 26 26 28 0 0 0 0 0 0 0 23
29 0 0 0 0 0 0 0 0 0 0 0 0 21 0 0 0 0 0 0 0 23
29 0 0 0 0 0 0 0 0 0 0 0 0 21 0 0 0 0 0 0 0 23
29 0 0 0 0 0 0 0 0 0 0 0 0 21 0 0 0 0 0 0 0 23
29 0 0 0 0 0 0 0 0 0 0 0 0 21 0 0 0 0 0 0 0 23
29 0 0 0 0 0 0 20 12 13 13 13 14 19 26 24 0 0 0 0 0 23
29 0 0 0 0 0 0 21 0 0 0 0 0 0 0 0 0 0 0 0 0 23
29 0 0 0 0 0 0 21 0 0 0 0 0 0 0 0 0 0 0 0 0 23
29 0 0 0 0 0 0 21 0 0 0 0 0 0 0 0 0 0 0 0 0 23
31 30 30 30 30 30 30 31 30 30 30 30 30 30 30 30 30 30 30 30 30 30
